Akh Va'quot Shrine: Windmills
Bareeda Naag Shrine: Cannon
Bosh Kala Shrine: The Wind Guides You
Chaas Qeta Shrine: A Major Test of Strength
Daag Chokah Shrine: Daag Chokah's Blessing
Dagah Keek Shrine: Dagah Keek's Blessing
Dah Hesho Shrine: A Minor Test of Strength
Dah Kaso Shrine: A Minor Test of Strength
Daka Tuss Shrine: Sunken Scoop
Dako Tah Shrine: Electric Path
Daqa Koh Shrine: Stalled Flight
Daqo Chisay Shrine: The Whole Picture
Dila Maag Shrine: Dila Maag's Blessing
Dow Na'eh Shrine: Three Boxes
Dunba Taag Shrine: Build and Release
Gee Ha'rah Shrine: Tandem
Goma Asaagh Shrine: A Major Test of Strength
Gorae Torr Shrine: Gorae Torr's Blessing
Ha Dahamar Shrine: The Water Guides
Hawa Koth Shrine: The Current Solution
Hia Miu Shrine: A Major Test of Strength
Hila Rao Shrine: Drifting
Ishto Soh Shrine: Bravery's Grasp
Ja Baij Shrine: Bomb Trial
Jee Noh Shrine: On the Move
Jitan Sa'mi Shrine: Jitan Sa'mi's Blessing
Joloo Nah Shrine: Joloo Nah Apparatus
Kaam Ya'tak Shrine: Trial of Power
Kah Mael Shrine: Drop and Rise
Kah Okeo Shrine: Wind Guide
Kah Yah Shrine: Quick Thinking
Kam Urog Shrine: Trial of Passage
Ka'o Makagh Shrine: Metal Doors Open the Way
Katah Chuki Shrine: A Minor Test of Strength
Katosa Aug Shrine: Katosa Aug Apparatus
Kay Noh Shrine: Power of Electricity
Kaya Wan Shrine: Shields from Water
Kayra Mah Shrine: Greedy Hill
Keeha Yoog Shrine: Keeha Yoog's Blessing
Keh Namut Shrine: Cryonis Trial
Kema Kosassa Shrine: A Major Test of Strength
Kema Zoos Shrine: A Delayed Puzzle
Ke'nai Shakah Shrine: A Modest Test of Strength
Keo Ruug Shrine: Fateful Stars
Ketoh Wawai Shrine: Ketoh Wawai's Blessing
Korgu Chideh Shrine: Korgu Chideh's Blessing
Korsh O'hu Shrine: Korsh O'hu's Blessing
Kuh Takkar Shrine: Melting Ice Hazard
Kuhn Sidajj Shrine: Kuhn Sidajj's Blessing
Lakna Rokee Shrine: Lakna Rokee's Blessing
Lanno Kooh Shrine: Lanno Kooh's Blessing
Maag Halan Shrine: Maag Halan's Blessing
Maag No'rah Shrine: Maag No'rah's Blessing
Maka Rah Shrine: Steady Thy Heart
Mezza Lo Shrine: Ancient Trifecta
Mijah Rokee Shrine: A Modest Test of Strength
Mirro Shaz Shrine: Tempered Power
Misae Suma Shrine: Misae Suma's Blessing
Mo'a Keet Shrine: Metal Makes a Path
Mogg Latan Shrine: Synced Swing
Monya Toma Shrine: Drawing Parabolas
Mozo Shenno Shrine: A Major Test of Strength
Muwo Jeem Shrine: A Modest Test of Strength
Myahm Agana Shrine: Myahm Agana Apparatus
Namika Ozz Shrine: A Modest Test of Strength
Ne'ez Yohma Shrine: Pushing Power
Noya Neha Shrine: A Minor Test of Strength
Oman Au Shrine: Magnesis Trial
Owa Daim Shrine: Stasis Trial
Pumaag Nitae Shrine: A Minor Test of Strength
Qaza Tokki Shrine: Qaza Tokki's Blessing
Qua Raym Shrine: A Balanced Approach
Qukah Nata Shrine: Qukah Nata's Blessing
Raqa Zunzo Shrine: Raqa Zunzo's Blessing
Ree Dahee Shrine: Timing Is Critical
Rin Oyaa Shrine: Directing the Wind
Ritaag Zumo Shrine: Ritaag Zumo's Blessing
Rok Uwog Shrine: Power of Reach
Rona Kachta Shrine: Rona Kachta's Blessing
Rota Ooh Shrine: Passing of the Gates
Rucco Maag Shrine: Five Flames
Saas Ko'sah Shrine: A Major Test of Strength
Sah Dahaj Shrine: Power of Fire
Sasa Kai Shrine: A Modest Test of Strength
Sha Gehma Shrine: Shift and Lock
Sha Warvo Shrine: Path of Hidden Winds
Shada Naw Shrine: Red Giveaway
Shae Katha Shrine: Shae Katha's Blessing
Shae Loya Shrine: Aim for the Moment
Shae Mo'sah Shrine: Swinging Flames
Shai Utoh Shrine: Halt the Tilt
Shai Yota Shrine: Shai Yota's Blessing
Shee Vaneer Shrine: Twin Memories
Shee Venath Shrine: Twin Memories
Sheh Rata Shrine: Speed of Light
Sheem Dagoze Shrine: Moving in Parallel
Sho Dantu Shrine: Two Bombs
Shoda Sah Shrine: Impeccable Timing
Shoqa Tatone Shrine: A Modest Test of Strength
Shora Hah Shrine: Blue Flame
Soh Kofi Shrine: A Minor Test of Strength
Suma Sahma Shrine: Suma Sahma's Blessing
Tah Muhl Shrine: Passing the Flame
Tahno O'ah Shrine: Tahno O'ah's Blessing
Ta'loh Naeg Shrine: Ta'loh Naeg's Teaching
Tawa Jinn Shrine: Tawa Jinn's Blessing
Tena Ko'sah Shrine: A Major Test of Strength
Tho Kayu Shrine: Tho Kayu's Blessing
To Quomo Shrine: To Quomo's Blessing
Toh Yahsa Shrine: Buried Secrets
Toto Sah Shrine: Toto Sah Apparatus
Tu Ka'loh Shrine: Tu Ka'loh's Blessing
Tutsuwa Nima Shrine: A Major Test of Strength
Voo Lota Shrine: The Winding Route
Wahgo Katta Shrine: Metal Connections
Ya Naga Shrine: Shatter the Heavens
Yah Rin Shrine: A Weighty Decision
Zalta Wa Shrine: Two Orbs to Guide You
Ze Kasho Shrine: Ze Kasho Apparatus
Zuna Kai Shrine: Zuna Kai's Blessing